10,10,10,10,10,10,10,10
10,00,00,00,00,00,00,10
10,00,00,00,00,00,00,10
10,00,00,00,00,00,00,10
10,00,00,00,00,00,00,10
10,00,00,00,00,00,00,10
10,00,00,00,00,00,00,10
10,10,10,10,10,10,10,10

1,1,1,1,1,1,1,1
1,0,0,0,0,0,0,1
1,0,0,0,0,0,0,1
1,0,0,0,0,0,0,1
1,0,0,0,0,0,0,1
1,0,0,0,0,0,0,1
1,0,0,0,0,0,0,1
1,1,1,1,1,1,1,1
